Room;assigned_room_type;reserved_room_type;Cost
A;A;A;4000000
B;B;B;4500000
C;C;C;4500000
D;D;D;4000000
E;E;E;3500000
F;F;F;4250000
G;G;G;4500000
H;H;H;4750000
I;I;I;3750000
J;J;J;4000000
K;K;K;3500000
